NO assets/no.xpm
SO assets/so.xpm
WE assets/we.xpm
EA assets/ea.xpm

F 220,100,0
C 225,30,0

11111111
10000001
10011001
10010001
100N0001
10000001
11111111
