NO assets/no.xpm
SO assets/so.xpm
WE assets/we.xpm
EA assets/ea.xpm

F 220,100,0
C 225,30,0

    1111
    1001
11111001
10000001
1000N001
10000001
11111111
