NO assets/no.xpm
SO assets/so.xpm
WE assets/we.xpm
EA assets/ea.xpm

F 220,100,0
C 225,30,0

        111111111111
        100000000001
        100000000001
111111111000000000011111111
100000000000000000000000001
100000000000N00000000000001
100000000000000000000000001
111111111000000000011111111
        100000000001
        100000000001
        111111111111
