NO assets/no.xpm
SO assets/so.xpm
WE assets/we.xpm
EA assets/ea.xpm

F 220,100,0
C 225,30,0

        1111111111111111111111111
        1000000000110000000000001
        1011000001110000000000001
        1001000000000000000000001
1111111110110000011100000000000011111
1000000000110000011101111111111110001
1111011111111101110000001000111110001
1111011111111101110101001000100010001
1100000011010101110000001000111110001
1000000000000000110000001000100000001
1000000000000000110101001000111111111
11000001110101011111011110N01
11110111 1110101 1011110100011
11111111 1111111 1111111111111
