NO assets/no.xpm
SO assets/so.xpm
WE assets/we.xpm
EA assets/ea.xpm

C 50,50,50
F 52,52,52

11111
1NNE1
11111
