NO assets/no.xpm
SO assets/so.xpm
WE assets/we.xpm
EA assets/ea.xpm

C 50,50,50
F 52,52,52

11111
10001
100010
10N01
11111
